########
###----#
P-#-##-#
#---##-E
########
